02,02,02,02,02,02,02,02,02,02,02,02,02,02,02
02,00,01,00,01,00,01,00,22,00,23,00,01,00,02
02,10,22,23,23,13,23,10,23,10,13,10,13,10,02
02,00,01,00,01,00,13,00,22,00,01,00,22,00,02
02,23,13,10,23,10,23,10,23,10,22,13,13,10,02
02,00,22,00,23,00,22,00,01,00,01,00,13,00,02
02,10,22,10,22,10,23,10,23,13,22,10,23,23,02
02,00,01,00,22,00,22,00,23,00,01,00,01,00,02
02,10,13,23,22,10,13,10,23,23,13,10,23,10,02
02,00,01,00,22,00,22,00,01,00,22,00,23,00,02
02,10,13,10,22,13,22,22,13,23,13,13,13,10,02
02,00,13,00,01,00,01,00,01,00,01,00,23,98,02
02,23,22,10,13,23,22,10,13,13,13,13,13,22,02
02,00,01,00,01,00,13,00,01,00,01,03,01,00,02
02,02,02,02,02,02,02,02,02,02,02,02,02,02,02